"filename", "language", "Dart", "comment", "blank", "total"
"c:\Users\renren\Desktop\tonoreader\lib\api\book_api.dart", "Dart", 13, 0, 2, 15
"c:\Users\renren\Desktop\tonoreader\lib\api\history_api.dart", "Dart", 2, 0, 2, 4
"c:\Users\renren\Desktop\tonoreader\lib\api\home_api.dart", "Dart", 13, 0, 2, 15
"c:\Users\renren\Desktop\tonoreader\lib\api\index.dart", "Dart", 8, 0, 3, 11
"c:\Users\renren\Desktop\tonoreader\lib\bindings\book_detail_binding.dart", "Dart", 8, 0, 2, 10
"c:\Users\renren\Desktop\tonoreader\lib\bindings\default_binding.dart", "Dart", 11, 0, 2, 13
"c:\Users\renren\Desktop\tonoreader\lib\bindings\index_binding.dart", "Dart", 14, 0, 2, 16
"c:\Users\renren\Desktop\tonoreader\lib\bindings\reader_binding.dart", "Dart", 8, 0, 2, 10
"c:\Users\renren\Desktop\tonoreader\lib\bindings\search_pre_binding.dart", "Dart", 8, 0, 2, 10
"c:\Users\renren\Desktop\tonoreader\lib\componets\book_cover.dart", "Dart", 43, 0, 4, 47
"c:\Users\renren\Desktop\tonoreader\lib\componets\expan_box.dart", "Dart", 59, 0, 10, 69
"c:\Users\renren\Desktop\tonoreader\lib\componets\loading_block.dart", "Dart", 19, 0, 2, 21
"c:\Users\renren\Desktop\tonoreader\lib\controller\user_info_controller.dart", "Dart", 2, 0, 2, 4
"c:\Users\renren\Desktop\tonoreader\lib\exception\book_load_exception.dart", "Dart", 8, 0, 1, 9
"c:\Users\renren\Desktop\tonoreader\lib\main.dart", "Dart", 26, 0, 4, 30
"c:\Users\renren\Desktop\tonoreader\lib\model\book_block.dart", "Dart", 22, 0, 2, 24
"c:\Users\renren\Desktop\tonoreader\lib\model\book_detail.dart", "Dart", 334, 20, 92, 446
"c:\Users\renren\Desktop\tonoreader\lib\model\book_info.dart", "Dart", 22, 0, 2, 24
"c:\Users\renren\Desktop\tonoreader\lib\model\book_reader.dart", "Dart", 10, 0, 1, 11
"c:\Users\renren\Desktop\tonoreader\lib\pages\detail\componets\detail_about.dart", "Dart", 110, 0, 4, 114
"c:\Users\renren\Desktop\tonoreader\lib\pages\detail\componets\detail_action.dart", "Dart", 37, 0, 5, 42
"c:\Users\renren\Desktop\tonoreader\lib\pages\detail\componets\detail_btn.dart", "Dart", 49, 0, 3, 52
"c:\Users\renren\Desktop\tonoreader\lib\pages\detail\componets\detail_chapter.dart", "Dart", 96, 0, 4, 100
"c:\Users\renren\Desktop\tonoreader\lib\pages\detail\componets\detail_head.dart", "Dart", 58, 0, 4, 62
"c:\Users\renren\Desktop\tonoreader\lib\pages\detail\componets\detail_series.dart", "Dart", 62, 0, 5, 67
"c:\Users\renren\Desktop\tonoreader\lib\pages\detail\componets\detail_statistics.dart", "Dart", 49, 0, 4, 53
"c:\Users\renren\Desktop\tonoreader\lib\pages\detail\controller.dart", "Dart", 23, 0, 2, 25
"c:\Users\renren\Desktop\tonoreader\lib\pages\detail\view.dart", "Dart", 158, 0, 9, 167
"c:\Users\renren\Desktop\tonoreader\lib\pages\index\componets\salomon_botton_bar.dart", "Dart", 140, 21, 24, 185
"c:\Users\renren\Desktop\tonoreader\lib\pages\index\controller.dart", "Dart", 8, 0, 2, 10
"c:\Users\renren\Desktop\tonoreader\lib\pages\index\feed\controller.dart", "Dart", 0, 0, 3, 3
"c:\Users\renren\Desktop\tonoreader\lib\pages\index\feed\view.dart", "Dart", 8, 0, 3, 11
"c:\Users\renren\Desktop\tonoreader\lib\pages\index\home\componets\book_info.dart", "Dart", 87, 0, 3, 90
"c:\Users\renren\Desktop\tonoreader\lib\pages\index\home\componets\item_block.dart", "Dart", 52, 0, 6, 58
"c:\Users\renren\Desktop\tonoreader\lib\pages\index\home\controller.dart", "Dart", 21, 0, 2, 23
"c:\Users\renren\Desktop\tonoreader\lib\pages\index\home\view.dart", "Dart", 115, 0, 6, 121
"c:\Users\renren\Desktop\tonoreader\lib\pages\index\shelf\controller.dart", "Dart", 26, 0, 3, 29
"c:\Users\renren\Desktop\tonoreader\lib\pages\index\shelf\subpage\collect\view.dart", "Dart", 10, 0, 3, 13
"c:\Users\renren\Desktop\tonoreader\lib\pages\index\shelf\subpage\history\view.dart", "Dart", 8, 0, 3, 11
"c:\Users\renren\Desktop\tonoreader\lib\pages\index\shelf\subpage\local\controller.dart", "Dart", 57, 0, 7, 64
"c:\Users\renren\Desktop\tonoreader\lib\pages\index\shelf\subpage\local\view.dart", "Dart", 73, 0, 3, 76
"c:\Users\renren\Desktop\tonoreader\lib\pages\index\shelf\view.dart", "Dart", 37, 0, 3, 40
"c:\Users\renren\Desktop\tonoreader\lib\pages\index\user\controller.dart", "Dart", 0, 0, 1, 1
"c:\Users\renren\Desktop\tonoreader\lib\pages\index\user\view.dart", "Dart", 84, 1, 7, 92
"c:\Users\renren\Desktop\tonoreader\lib\pages\index\view.dart", "Dart", 27, 0, 3, 30
"c:\Users\renren\Desktop\tonoreader\lib\pages\login\controller.dart", "Dart", 0, 0, 1, 1
"c:\Users\renren\Desktop\tonoreader\lib\pages\login\view.dart", "Dart", 8, 0, 3, 11
"c:\Users\renren\Desktop\tonoreader\lib\pages\reader\controller.dart", "Dart", 5, 0, 2, 7
"c:\Users\renren\Desktop\tonoreader\lib\pages\reader\view.dart", "Dart", 15, 0, 3, 18
"c:\Users\renren\Desktop\tonoreader\lib\pages\search_pre\controller.dart", "Dart", 2, 0, 2, 4
"c:\Users\renren\Desktop\tonoreader\lib\pages\search_pre\view.dart", "Dart", 10, 0, 3, 13
"c:\Users\renren\Desktop\tonoreader\lib\pages\test\controller.dart", "Dart", 13, 0, 2, 15
"c:\Users\renren\Desktop\tonoreader\lib\pages\test\view.dart", "Dart", 21, 0, 2, 23
"c:\Users\renren\Desktop\tonoreader\lib\routes\void_routers.dart", "Dart", 36, 0, 2, 38
"c:\Users\renren\Desktop\tonoreader\lib\tono_reader\config.dart", "Dart", 13, 9, 10, 32
"c:\Users\renren\Desktop\tonoreader\lib\tono_reader\controller.dart", "Dart", 70, 0, 13, 83
"c:\Users\renren\Desktop\tonoreader\lib\tono_reader\data_provider\local_data_provider.dart", "Dart", 50, 0, 9, 59
"c:\Users\renren\Desktop\tonoreader\lib\tono_reader\data_provider\net_data_provider.dart", "Dart", 1, 0, 1, 2
"c:\Users\renren\Desktop\tonoreader\lib\tono_reader\data_provider\tono_data_provider.dart", "Dart", 6, 2, 4, 12
"c:\Users\renren\Desktop\tonoreader\lib\tono_reader\model\base\tono.dart", "Dart", 39, 5, 10, 54
"c:\Users\renren\Desktop\tonoreader\lib\tono_reader\model\base\tono_book_info.dart", "Dart", 40, 0, 5, 45
"c:\Users\renren\Desktop\tonoreader\lib\tono_reader\model\base\tono_type.dart", "Dart", 1, 0, 1, 2
"c:\Users\renren\Desktop\tonoreader\lib\tono_reader\model\config.dart", "Dart", 13, 8, 6, 27
"c:\Users\renren\Desktop\tonoreader\lib\tono_reader\model\parser\tono_opf_parse_result.dart", "Dart", 1, 0, 1, 2
"c:\Users\renren\Desktop\tonoreader\lib\tono_reader\model\parser\tono_selector_group.dart", "Dart", 25, 0, 3, 28
"c:\Users\renren\Desktop\tonoreader\lib\tono_reader\model\parser\tono_selector_info.dart", "Dart", 8, 0, 3, 11
"c:\Users\renren\Desktop\tonoreader\lib\tono_reader\model\parser\tono_selector_part.dart", "Dart", 25, 0, 1, 26
"c:\Users\renren\Desktop\tonoreader\lib\tono_reader\model\parser\tono_style_sheet_block.dart", "Dart", 9, 0, 3, 12
"c:\Users\renren\Desktop\tonoreader\lib\tono_reader\model\style\tono_border.dart", "Dart", 0, 0, 1, 1
"c:\Users\renren\Desktop\tonoreader\lib\tono_reader\model\style\tono_border_style.dart", "Dart", 0, 0, 1, 1
"c:\Users\renren\Desktop\tonoreader\lib\tono_reader\model\style\tono_font_family.dart", "Dart", 0, 0, 1, 1
"c:\Users\renren\Desktop\tonoreader\lib\tono_reader\model\style\tono_font_size.dart", "Dart", 0, 0, 1, 1
"c:\Users\renren\Desktop\tonoreader\lib\tono_reader\model\style\tono_font_weight.dart", "Dart", 0, 0, 1, 1
"c:\Users\renren\Desktop\tonoreader\lib\tono_reader\model\style\tono_height.dart", "Dart", 0, 0, 1, 1
"c:\Users\renren\Desktop\tonoreader\lib\tono_reader\model\style\tono_line_height.dart", "Dart", 0, 0, 1, 1
"c:\Users\renren\Desktop\tonoreader\lib\tono_reader\model\style\tono_margin.dart", "Dart", 0, 0, 1, 1
"c:\Users\renren\Desktop\tonoreader\lib\tono_reader\model\style\tono_padding.dart", "Dart", 0, 0, 1, 1
"c:\Users\renren\Desktop\tonoreader\lib\tono_reader\model\style\tono_style.dart", "Dart", 27, 4, 8, 39
"c:\Users\renren\Desktop\tonoreader\lib\tono_reader\model\style\tono_text_align.dart", "Dart", 0, 0, 1, 1
"c:\Users\renren\Desktop\tonoreader\lib\tono_reader\model\widget\tono_container.dart", "Dart", 31, 2, 6, 39
"c:\Users\renren\Desktop\tonoreader\lib\tono_reader\model\widget\tono_image.dart", "Dart", 22, 0, 4, 26
"c:\Users\renren\Desktop\tonoreader\lib\tono_reader\model\widget\tono_ruby.dart", "Dart", 42, 0, 5, 47
"c:\Users\renren\Desktop\tonoreader\lib\tono_reader\model\widget\tono_text.dart", "Dart", 30, 0, 6, 36
"c:\Users\renren\Desktop\tonoreader\lib\tono_reader\model\widget\tono_widget.dart", "Dart", 35, 0, 5, 40
"c:\Users\renren\Desktop\tonoreader\lib\tono_reader\parser\tono_opf_parser.dart", "Dart", 103, 0, 7, 110
"c:\Users\renren\Desktop\tonoreader\lib\tono_reader\parser\tono_parser.dart", "Dart", 17, 2, 3, 22
"c:\Users\renren\Desktop\tonoreader\lib\tono_reader\parser\tono_selector_macher.dart", "Dart", 305, 6, 17, 328
"c:\Users\renren\Desktop\tonoreader\lib\tono_reader\parser\tono_selector_parser.dart", "Dart", 96, 7, 18, 121
"c:\Users\renren\Desktop\tonoreader\lib\tono_reader\parser\tono_style_parser.dart", "Dart", 256, 28, 29, 313
"c:\Users\renren\Desktop\tonoreader\lib\tono_reader\parser\tono_widget_parser.dart", "Dart", 59, 4, 6, 69
"c:\Users\renren\Desktop\tonoreader\lib\tono_reader\parser\widget_parser\container_parser.dart", "Dart", 84, 0, 3, 87
"c:\Users\renren\Desktop\tonoreader\lib\tono_reader\parser\widget_parser\img_parser.dart", "Dart", 24, 0, 2, 26
"c:\Users\renren\Desktop\tonoreader\lib\tono_reader\parser\widget_parser\ruby_parser.dart", "Dart", 56, 0, 2, 58
"c:\Users\renren\Desktop\tonoreader\lib\tono_reader\render\content\tono_image_widget.dart", "Dart", 58, 0, 6, 64
"c:\Users\renren\Desktop\tonoreader\lib\tono_reader\render\css_impl\tono_css_border_bgc.dart", "Dart", 28, 6, 3, 37
"c:\Users\renren\Desktop\tonoreader\lib\tono_reader\render\css_impl\tono_css_display_widget.dart", "Dart", 26, 5, 4, 35
"c:\Users\renren\Desktop\tonoreader\lib\tono_reader\render\css_impl\tono_css_margin_widget.dart", "Dart", 38, 2, 2, 42
"c:\Users\renren\Desktop\tonoreader\lib\tono_reader\render\css_impl\tono_css_size_padding_widget.dart", "Dart", 75, 9, 10, 94
"c:\Users\renren\Desktop\tonoreader\lib\tono_reader\render\css_impl\tono_css_transform_widget.dart", "Dart", 20, 3, 4, 27
"c:\Users\renren\Desktop\tonoreader\lib\tono_reader\render\css_impl\tono_css_widget.dart", "Dart", 12, 0, 4, 16
"c:\Users\renren\Desktop\tonoreader\lib\tono_reader\render\css_parse\tono_css_align_item.dart", "Dart", 16, 2, 2, 20
"c:\Users\renren\Desktop\tonoreader\lib\tono_reader\render\css_parse\tono_css_background_color.dart", "Dart", 9, 0, 2, 11
"c:\Users\renren\Desktop\tonoreader\lib\tono_reader\render\css_parse\tono_css_background_image.dart", "Dart", 12, 0, 2, 14
"c:\Users\renren\Desktop\tonoreader\lib\tono_reader\render\css_parse\tono_css_background_position.dart", "Dart", 41, 0, 2, 43
"c:\Users\renren\Desktop\tonoreader\lib\tono_reader\render\css_parse\tono_css_background_size.dart", "Dart", 65, 0, 4, 69
"c:\Users\renren\Desktop\tonoreader\lib\tono_reader\render\css_parse\tono_css_border.dart", "Dart", 51, 0, 4, 55
"c:\Users\renren\Desktop\tonoreader\lib\tono_reader\render\css_parse\tono_css_border_radius.dart", "Dart", 10, 0, 2, 12
"c:\Users\renren\Desktop\tonoreader\lib\tono_reader\render\css_parse\tono_css_box_shadow.dart", "Dart", 17, 0, 2, 19
"c:\Users\renren\Desktop\tonoreader\lib\tono_reader\render\css_parse\tono_css_converter.dart", "Dart", 232, 37, 55, 324
"c:\Users\renren\Desktop\tonoreader\lib\tono_reader\render\css_parse\tono_css_display.dart", "Dart", 14, 4, 3, 21
"c:\Users\renren\Desktop\tonoreader\lib\tono_reader\render\css_parse\tono_css_height.dart", "Dart", 53, 13, 10, 76
"c:\Users\renren\Desktop\tonoreader\lib\tono_reader\render\css_parse\tono_css_image_repet.dart", "Dart", 12, 0, 2, 14
"c:\Users\renren\Desktop\tonoreader\lib\tono_reader\render\css_parse\tono_css_justify_content.dart", "Dart", 17, 2, 2, 21
"c:\Users\renren\Desktop\tonoreader\lib\tono_reader\render\css_parse\tono_css_margin.dart", "Dart", 23, 0, 5, 28
"c:\Users\renren\Desktop\tonoreader\lib\tono_reader\render\css_parse\tono_css_padding.dart", "Dart", 28, 8, 4, 40
"c:\Users\renren\Desktop\tonoreader\lib\tono_reader\render\css_parse\tono_css_tansform.dart", "Dart", 26, 3, 3, 32
"c:\Users\renren\Desktop\tonoreader\lib\tono_reader\render\css_parse\tono_css_text_align.dart", "Dart", 15, 0, 2, 17
"c:\Users\renren\Desktop\tonoreader\lib\tono_reader\render\css_parse\tono_css_transform_origin.dart", "Dart", 21, 2, 2, 25
"c:\Users\renren\Desktop\tonoreader\lib\tono_reader\render\css_parse\tono_css_width.dart", "Dart", 52, 13, 10, 75
"c:\Users\renren\Desktop\tonoreader\lib\tono_reader\render\state\tono_container_provider.dart", "Dart", 29, 0, 6, 35
"c:\Users\renren\Desktop\tonoreader\lib\tono_reader\render\state\tono_container_state.dart", "Dart", 63, 0, 3, 66
"c:\Users\renren\Desktop\tonoreader\lib\tono_reader\render\state\tono_css_provider.dart", "Dart", 45, 0, 6, 51
"c:\Users\renren\Desktop\tonoreader\lib\tono_reader\render\widget\inline\tono_container_render.dart", "Dart", 28, 0, 2, 30
"c:\Users\renren\Desktop\tonoreader\lib\tono_reader\render\widget\inline\tono_image_render.dart", "Dart", 24, 0, 3, 27
"c:\Users\renren\Desktop\tonoreader\lib\tono_reader\render\widget\inline\tono_inline_render.dart", "Dart", 1, 0, 1, 2
"c:\Users\renren\Desktop\tonoreader\lib\tono_reader\render\widget\inline\tono_text_render.dart", "Dart", 144, 0, 14, 158
"c:\Users\renren\Desktop\tonoreader\lib\tono_reader\render\widget\tono_container_widget.dart", "Dart", 61, 0, 5, 66
"c:\Users\renren\Desktop\tonoreader\lib\tono_reader\render\widget\tono_inline_container_widget.dart", "Dart", 53, 0, 5, 58
"c:\Users\renren\Desktop\tonoreader\lib\tono_reader\render\widget\tono_outer_widget.dart", "Dart", 108, 8, 8, 124
"c:\Users\renren\Desktop\tonoreader\lib\tono_reader\render\widget\tono_ruby_widget.dart", "Dart", 130, 0, 12, 142
"c:\Users\renren\Desktop\tonoreader\lib\tono_reader\state\tono_assets_provider.dart", "Dart", 9, 0, 3, 12
"c:\Users\renren\Desktop\tonoreader\lib\tono_reader\state\tono_data_provider.dart", "Dart", 53, 0, 6, 59
"c:\Users\renren\Desktop\tonoreader\lib\tono_reader\state\tono_flager.dart", "Dart", 9, 0, 2, 11
"c:\Users\renren\Desktop\tonoreader\lib\tono_reader\state\tono_initializer.dart", "Dart", 39, 0, 7, 46
"c:\Users\renren\Desktop\tonoreader\lib\tono_reader\state\tono_prepager.dart", "Dart", 18, 0, 2, 20
"c:\Users\renren\Desktop\tonoreader\lib\tono_reader\state\tono_progresser.dart", "Dart", 15, 0, 10, 25
"c:\Users\renren\Desktop\tonoreader\lib\tono_reader\tool\after_layout.dart", "Dart", 32, 0, 10, 42
"c:\Users\renren\Desktop\tonoreader\lib\tono_reader\tool\async_memory_image.dart", "Dart", 74, 5, 14, 93
"c:\Users\renren\Desktop\tonoreader\lib\tono_reader\tool\botted_box_border.dart", "Dart", 119, 13, 14, 146
"c:\Users\renren\Desktop\tonoreader\lib\tono_reader\tool\box_decoration.dart", "Dart", 424, 3, 50, 477
"c:\Users\renren\Desktop\tonoreader\lib\tono_reader\tool\constained_row.dart", "Dart", 46, 6, 6, 58
"c:\Users\renren\Desktop\tonoreader\lib\tono_reader\tool\css_tool.dart", "Dart", 130, 3, 20, 153
"c:\Users\renren\Desktop\tonoreader\lib\tono_reader\tool\dashed_box_border.dart", "Dart", 137, 2, 9, 148
"c:\Users\renren\Desktop\tonoreader\lib\tono_reader\tool\error_boundary.dart", "Dart", 33, 3, 9, 45
"c:\Users\renren\Desktop\tonoreader\lib\tono_reader\tool\margin.dart", "Dart", 125, 11, 20, 156
"c:\Users\renren\Desktop\tonoreader\lib\tono_reader\tool\nav_darwer.dart", "Dart", 84, 0, 2, 86
"c:\Users\renren\Desktop\tonoreader\lib\tono_reader\tool\pager.dart", "Dart", 295, 0, 22, 317
"c:\Users\renren\Desktop\tonoreader\lib\tono_reader\tool\path_tool.dart", "Dart", 11, 0, 2, 13
"c:\Users\renren\Desktop\tonoreader\lib\tono_reader\tool\reversed_column.dart", "Dart", 75, 1, 7, 83
"c:\Users\renren\Desktop\tonoreader\lib\tono_reader\tool\span_table.dart", "Dart", 162, 11, 37, 210
"c:\Users\renren\Desktop\tonoreader\lib\tono_reader\tool\styled_border.dart", "Dart", 201, 7, 28, 236
"c:\Users\renren\Desktop\tonoreader\lib\tono_reader\tool\text_splitd.dart", "Dart", 31, 0, 4, 35
"c:\Users\renren\Desktop\tonoreader\lib\tono_reader\tool\tono_serializer.dart", "Dart", 54, 6, 11, 71
"c:\Users\renren\Desktop\tonoreader\lib\tono_reader\tool\unit8_tool.dart", "Dart", 7, 0, 2, 9
"c:\Users\renren\Desktop\tonoreader\lib\tono_reader\ui\default\bottom_bar_view.dart", "Dart", 25, 0, 4, 29
"c:\Users\renren\Desktop\tonoreader\lib\tono_reader\ui\default\content_view.dart", "Dart", 71, 0, 5, 76
"c:\Users\renren\Desktop\tonoreader\lib\tono_reader\ui\default\paging_view.dart", "Dart", 61, 0, 3, 64
"c:\Users\renren\Desktop\tonoreader\lib\tono_reader\ui\default\setting_view.dart", "Dart", 0, 0, 1, 1
"c:\Users\renren\Desktop\tonoreader\lib\tono_reader\ui\default\slide_content_view.dart", "Dart", 25, 0, 2, 27
"c:\Users\renren\Desktop\tonoreader\lib\tono_reader\ui\default\top_bar_view.dart", "Dart", 54, 0, 4, 58
"c:\Users\renren\Desktop\tonoreader\lib\tono_reader\view.dart", "Dart", 79, 3, 7, 89
"c:\Users\renren\Desktop\tonoreader\lib\tono_reader\widget_provider\local_tono_widget_provider.dart", "Dart", 132, 5, 17, 154
"c:\Users\renren\Desktop\tonoreader\lib\tono_reader\widget_provider\tono_widget_provider.dart", "Dart", 16, 0, 3, 19
"c:\Users\renren\Desktop\tonoreader\lib\utils\setting.dart", "Dart", 22, 2, 5, 29
"c:\Users\renren\Desktop\tonoreader\lib\utils\type.dart", "Dart", 5, 0, 1, 6
"Total", "-", 7953, 317, 1047, 9317